[
    {
        "name": "Level 1",
        "level_data": [
            "####################",
            "#..@...............#",
            "#..................#",
            "#..................#",
            "####################"
        ]
    },
    {
        "name":"Level 2"
    }
]